
NO ./imgs/3_dirty-bricks-texture-seamless.xpm
SO ./imgs/42_old-damaged-bricks-texture-seamless.xpm
WE ./imgs/49_Italian-stone-wall_DIFF.xpm
EA ./imgs/80_old-bricks-texture-seamless-2.xpm

F 225,100,0
C 225,30,0

111111111111111111
1011001001001001001
10010010010010010011
1001001001001001001
1001001000001001011
10S0000000000000001
1000011111111000001
11110000000000011111
1000000101010000001
1111111111111111111
