NO imgs/CRATE_1D.xpm
SO imgs/DOOR_1A.xpm
WE imgs/DOOR_1E.xpm
EA imgs/DOOR_1E.xpm

F 255,0,0
C 225,3,0

        1111111111111111111111111
        1000000000110000000000001
        1011000001110000000000001
        1001000000000000000000001
111111111011000001110000000000001
100000000011000001110111111111111
11110111111111011100000010001
11110111111111011101010010001
11010000110101011100000010001
101 1E00000000000001100000011
10010000000000001101010010001
110000011101010111110111100111
11110111 1110101 101111010001
11111111 1111111 111111111111
