NO imgs/d-pixel-art-night-village-317499370.xpm
SO imgs/d-pixel-art-night-village-317499405.xpm
WE imgs/pixel-art-village-night-under-starry-sky-trees-houses-flowers-digital-painting-380524559.xpm
EA imgs/d-pixel-art-night-village-317499395.xpm

F 15, 25, 50
C 25, 40, 75




        1111111111111111111111111
        1000000000110000000000001
        1011000001110000000000001
        1001000000000000000000001
111111111011000001110000000000001
100000000011000001110111111111111
1111011111111101110000001001
11110111111111011101010010001
11010000110101011100000010001
101 1E1000000000000110000001
10010000000000001101010010001
110000011101010111110111100111
11110111 1110101 101111010001
1111111111111111 111111111111

