 NO imgs/CRATE_1D.xpm
SO imgs/DOOR_1A.xpm
WE imgs/DOOR_1E.xpm
EA imgs/DOOR_1E.xpm

C 155,155,155
F 115,204,254

11111111111111111
11100000000000011
1110N000000000011
11100000010000011
11111100011000011
11100000000000011
11100000000000011
11100000000000011
11111000000000011
11100000100000011
11111111111111111
